....................
....................
........┌────┐......
........│....│......
......┌─┘■■■.│......
......│..■□□.│......
......│.■□□□┌┘......
......└──┐..│.......
.........└──┘.......
....................
....................
