....................
....................
.......┌─┐..........
.......│□│..........
.......│.└──┐.......
.....┌─┘■.■□│.......
.....│□.■.┌─┘.......
.....└──┐■│.........
........│□│.........
........└─┘.........
....................
