....................
....................
.......┌──┐.........
.......│..└─┐.......
.......│.■..│.......
......┌─┐.│.└┐......
......│□│.│..│......
......│□■..│.│......
......│□...■.│......
......└──────┘......
....................
