....................
.....┌───┐..........
.....│...│..........
.....│.■.│.┌─┐......
.....│.■■│.│□│......
.....└─┐.└─┘□│......
......┌┘....□│......
......│...┬..│......
......│...┌──┘......
......└───┘.........
....................
