....................
....................
........┌───┐.......
......┌─┘...│.......
......│..■□.└┐......
......│..□■□.│......
......└─┐.▣■.│......
........│...┌┘......
........└───┘.......
....................
....................
