┌──────────────────┐
│..................│
│..................│
│┌─.─┬─.┌─┐.┌─┐.─┬─│
│└┐..│..│─│.│┌┘..│.│
│─┘..│..│.│.│└┐..│.│
│..................│
│.........■........│
│.........□........│
│..................│
└──────────────────┘