....................
......┌──┐..........
.....┌┘..│..........
.....│..■│..........
.....└┐■.└┐.........
.....┌┘.■.│.........
.....│□■..│.........
.....│□□▣□│.........
.....└────┘.........
....................
....................
