....................
.....┌────────┐.....
.....│.──┐...□│.....
.....│...│...□│.....
.....│...│....│.....
.....│...│....│.....
.....│........│.....
.....│........│.....
.....│...■■...│.....
.....│........│.....
.....└────────┘.....
....................