....................
........┌───┐.......
......┌─┘...│.......
......│□.■..│.......
......┌─┐.■□│.......
......│□┌─■.│.......
......│.╵.□.└┐......
......│■.▣■■□│......
......│...□..│......
......└──────┘......
....................
